{
  "meta": {
    "version": 1,
    "generated": "2025-10-02T00:16:00Z",
    "author": "Codex Asset Pipeline"
  },
  "stages": [
    {
      "id": "intro-garden",
      "name": "Intro Garden",
      "theme": "sunrise_meadow",
      "size": {
        "width": 48,
        "height": 32
      },
      "spawn": {
        "x": 4,
        "y": 20
      },
      "layout": [
        "################################################",
        "#....................oooo.......................#",
        "#....................oooo.......................#",
        "#...........######..............................#",
        "#...........#....#..............................#",
        "#.....oooo..#....#...............oooo...........#",
        "#.....oooo..#....#...............oooo...........#",
        "#...........#....#..............................#",
        "#...........######..............................#",
        "#...............................................#",
        "#...............................................#",
        "#....................oooo.......................#",
        "#....................oooo.......................#",
        "#...............................................#",
        "#.............###########.......................#",
        "#.............#.........#.......................#",
        "#.....oooo....#...@.....#........oooo...........#",
        "#.....oooo....#.........#........oooo...........#",
        "#.............###########.......................#",
        "#...............................................#",
        "#...............................................#",
        "#...............................................#",
        "################################################"
      ],
      "collectibles": [
        {
          "type": "star_fragment",
          "x": 12,
          "y": 12
        },
        {
          "type": "star_fragment",
          "x": 32,
          "y": 8
        }
      ],
      "notes": "A gentle opening arena with soft onboarding and a simple inhale target."
    },
    {
      "id": "mirror-maze",
      "name": "Mirror Maze",
      "theme": "twilight_palace",
      "size": {
        "width": 48,
        "height": 32
      },
      "spawn": {
        "x": 2,
        "y": 28
      },
      "layout": [
        "################################################",
        "#..........#.....................#..............#",
        "#..........#.....................#..............#",
        "#..######..######.....######.....######..######.#",
        "#..#....#..#....#.....#....#.....#....#..#....#.#",
        "#..#....#..#....#.....#....#.....#....#..#....#.#",
        "#..######..######.....######.....######..######.#",
        "#..............................................#",
        "#..............................................#",
        "#..######..######.....######.....######..######.#",
        "#..#....#..#....#.....#....#.....#....#..#....#.#",
        "#..#....#..#....#.....#....#.....#....#..#....#.#",
        "#..######..######.....######.....######..######.#",
        "#..............................................#",
        "#..............................................#",
        "#..........#.....................#..............#",
        "#..........#.....................#..............#",
        "################################################"
      ],
      "collectibles": [
        {
          "type": "mirror_essence",
          "x": 22,
          "y": 6
        },
        {
          "type": "mirror_essence",
          "x": 26,
          "y": 26
        }
      ],
      "notes": "Duplicated corridors hide mirrored enemies. Tiles align with the supplied tileset palette."
    }
  ]
}
